----------------------------------------
----------------------------------------
---------=======================--------
--------|            @          |-------
--------|   ==================  |-------
-------|    ==================   |------
-------|    ======|  |====|  |==   |----
-------| @  ======|  |====|  |== @ |----
-------|    ======|  |====|  |=    |----
-------|    ==================   |------
-------|    =================   |-------
-------|  @ ===============   |---------
-------|         ==         |-----------
-------------|      |-------------------
-------------|    |---------------------
--------------====----------------------
----------------------------------------
----------------------------------------